Tony’s Italian Delicatessen – Montgomery, TX
Franky’s Deli Warehouse – Hialeah, FL
Afghan Bistro – Springfield, VA
AJ’s Press – Tampa, FL
TKB Bakery & Deli – Indio, CA
Bell Street Farm – Los Alamos, CA
Sammy D’s Cafe – Lake George, NY
Ciao! Pizza And Pasta – Chelsea, MA
Fratellino – Coral Gables, FL
Fox Smokehouse Bbq – Boulder City, NV
Little Miss BBQ – Phoenix, AZ
Frenchman’s Cafe – Kailua-Kona, HI
Yo-Way – Gardena, CA
The Shawarma Factory – Gardena, CA
Corner Grille – Panorama City, CA
Prunedale Market – Salinas, CA
Saverio’s Authentic Pizza Napoletana – Massapequa, NY
Boteco – Austin, TX
The Red Dot Vegetarian Kitchen – Frazier Park, CA
Tacos Manuel – Santa Ana, CA
Tommy Tamale Market & Cafe – Grapevine, TX
Nonla Vietnamese Street Food – Mattawan, MI
Arun’s Indian Kitchen – Coral Springs, FL
Bangers & Brews – Bend, OR
Barracuda Deli Cafe – St. Pete Beach, FL
Rodini Park – Los Angeles, CA
Maple Street Biscuit Company – Saint Augustine, FL*
Blues City Deli – Saint Louis, MO
Blue Seafood & Spirits – Virginia Beach, VA
Kaaloa’s Super J’s – Captain Cook, HI
International House of Hot Dogs – Anchorage, AK
JJ’s Caffe – Brockton, MA
Locomotive Cafe – Canoga Park, CA
Neighborhood Eats – Atlanta, GA
Juana La Cubana Cafe – Fort Lauderdale, FL
Thai Mee Up – Kahului, HI
167 Raw – Charleston, SC
Momo Ghar – Columbus, OH
Back Draft Pizzeria – Bee Cave, TX
Taqueria Mi Ranchito – Sylmar, CA
Mazaa Kabob House – Tracy, CA
King Mediterrano – Torrance, CA
United Rose Deli & Pho – Orange, CA
La Maison de Maggie – Las Vegas, NV
Chirashi Sushi Don by Jiro – Kailua-Kona, HI
Smiling With Hope Pizza – Reno, NV
Daddy O’s Rockin Cafe – Upland, CA
Falafelle – Belmont, CA
The House of Gyros – Mesquite, TX
Tasty Food To Go – Long Beach, CA
Sunny Side Kitchen – Escondido, CA
Sa Bai Thai Cuisine – Portland, OR
Irie’s Island Food – Port Aransas, TX
Island Bree’z – Kahuku, HI
Trigo Cafe – Hialeah, FL
Worth Takeaway – Mesa, AZ
Aloha Shrimp – Hauula, HI
Mr & Mrs Bun – Miami, FL
El Frescos Cocina Mexicana – Las Vegas, NV
Le’ Pam’s House of Creole – Houston, TX
Sultan Bakery and Grill – Murrieta, CA
Kenko Sushi – Lincoln Park, NJ
Appu’s Cafe – Long Beach, CA
Papa Marcos Grill And Kabob – Waukegan, IL
Crazy Hot Wings – Tujunga, CA
Tizon Bistro – El Monte, CA
Dar Essalam – Wilsonville, OR
SKADI – Mammoth Lake, CA
Saigon Beach – Newport Beach, CA
Super Subs – Banning, CA
Balam Mexican Kitchen – Lynwood, CA
Halls Chophouse – Charleston, SC
NOM Kauai – Kapaa, HI
Delauders Smoky Mountain BBQ – Gatlinburg, TN
Carnitas El Rey – Oxnard, CA
Kobee Factory – Van Nuys, CA
Mr Kebap – Fountain Valley, CA
Shabu Shabu Zen and Sake Bar – Rancho Mirage, CA
Makai Sushi – Koloa, HI
Dizin Persian Cuisine – Los Angeles, CA
Pickles & Swiss – Santa Barbara, CA
Loli’s Mexican Cravings – Tampa, FL
Yoyo’s Hot Dog – Houston, TX
Cuisine of Nepal – San Francisco, CA
Choupli Wood Fired Kabob – Lansing, MI
KoKyu Na’Mean – Durham, NC
PDX Sliders – Portland, OR
NoHo Cafe – Los Angeles, CA
Las Tortas Perronas – Houston, TX
Yolk, White & Associates – Tampa, FL
Blunozer Cafe – Denver, CO
Juice Joint Deli – San Juan Capistrano, CA
Sierra Subs and Salads – Three Rivers, CA
Playground 2.0 – Santa Ana, CA
Porky’s – Waimea, HI
Carlitos Cocina Mexican Restaurant – Sparks, NV
Chadd’s Bistro – Rochester Hills, MI
Mediterranean Grill – Fargo, ND
L’industrie Pizzeria – Williamsburg, NY
Classics Malt Shop – San Diego, CA